 1 1 1 1   1 1 1 1 1 1 1  1 1 1 1 1 1 1  1 1 1 1 1 1 1   1 1 1 1
 1 1 1 1   1 1 1 1 1 1 1  1 1 1 1 1 1 1  1 1 1 1 1 1 1   1 1 1 1
 1 1 1 1   1 1 1 1 1 1 1  1 1 1 1 1 1 1  1 1 1 1 1 1 1   1 1 1 1
 1 1 1 1   1 1 1 1 1 1 1  1 1 1 1 1 1 1  1 1 1 1 1 1 1   1 1 1 1
 1 1 1 1   1 1 1 1 1 1 1  1 1 1 1 1 1 1  1 1 1 1 1 1 1   1 1 1 1
 1 1 1 1   1 1 1 1 1 1 1  1 1 1 1 1 1 1  1 1 1 1 1 1 1   1 1 1 1
 1 1 1 1   1 1 1 1 1 1 1  1 1 1 1 1 1 1  1 1 1 1 1 1 1   1 1 1 1
 1 1 1 1   1 1 1 1 1 1 1  1 1 1 1 1 1 1  1 1 1 1 1 1 1   1 1 1 1

 1 1 1 1   1 32 32 32 32 32 32  32 32 32 32 32 32 32  32 32 32 32 32 32 1   1 1 1 1
 1 1 1 1   1 32 21 32 32 32 32  32 32 32 32 32 32 21  32 32 32 32 32 32 1   1 1 1 1
 1 1 1 1   1 32 32 32 32 32 32  32 32 32 32 32 32 32  32 32 32 32 32 32 1   1 1 1 1
 1 1 1 1   1 32 32 32 32 32 32  32 32 32 32 32 32 32  32 32 32 32 32 32 1   1 1 1 1
 1 1 1 1   1 32 32 32 32 32 32  32 32 32 32 32 32 32  32 32 32 32 32 32 1   1 1 1 1
 1 1 1 1   1 32 21 32 32 32 32  32 32 32 32 32 32 32  32 32 32 32 32 32 1   1 1 1 1
 1 1 1 1   1 32 32 32 32 32 32  32 32 32 32 32 32 32  32 32 32 32 32 32 1   1 1 1 1
 1 1 1 1   1 32 32 32 32 32 32  32 32 32 21 32 32 32  32 32 32 32 32 32 1   1 1 1 1
 1 1 1 1   1 32 32 32 32 32 32  32 32 32 32 32 32 32  32 32 32 32 32 32 1   1 1 1 1
 1 1 1 1   1 32 32 32 32 32 32  32 32 32 32 32 32 32  32 32 32 32 32 32 1   1 1 1 1
 1 1 1 1   1 32 32 32 32 32 32  32 32 32 32 32 32 32  32 32 32 21 32 32 1   1 1 1 1
 1 1 1 1   1 32 32 32 32 32 32  32 32 32 32 32 32 32  32 32 32 21 32 32 1   1 1 1 1
 1 1 1 1   1 32 32 32 32 32 32  32 32 32 32 32 32 32  32 32 32 21 32 32 1   1 1 1 1
 1 1 1 1   1 32 32 32 32 32 32  32 32 32 32 32 32 32  32 32 32 21 32 32 1   1 1 1 1

 1 1 1 1   1 32 32 32 32 32 32  32 32 32 32 32 32 32  32 32 32 32 21 32 1   1 1 1 1
 1 1 1 1   1 32 32 32 32 32 32  32 32 32 32 32 32 32  32 32 32 32 32 32 1   1 1 1 1
 1 1 1 1   1 32 32 32 32 32 36  35 37 32 32 32 32 32  32 32 32 32 32 32 1   1 1 1 1
 1 1 1 1   1 32 32 32 32 32 41  40 42 32 32 32 32 32  32 32 32 32 32 32 1   1 1 1 1
 1 1 1 1   1 32 32 32 32 32 39  38 43 32 32 32 32 32  32 32 32 32 32 32 1   1 1 1 1
 1 1 1 1   1 32 32 32 32 32 32  32 32 32 32 32 32 32  32 32 32 32 32 32 1   1 1 1 1
 1 1 1 1   1 32 32 32 32 32 32  32 32 32 32 32 32 32  32 32 32 32 32 32 1   1 1 1 1
 1 1 1 1   1 32 32 32 32 32 32  32 32 32 21 32 32 32  32 32 32 32 32 32 1   1 1 1 1
 1 1 1 1   1 32 32 32 32 32 32  32 32 32 32 32 32 32  32 32 32 32 32 32 1   1 1 1 1
 1 1 1 1   1 32 32 32 32 32 32  32 32 32 32 32 32 32  32 32 32 32 32 32 1   1 1 1 1
 1 1 1 1   1 32 32 32 32 32 32  32 32 32 32 32 32 32  32 32 32 21 32 32 1   1 1 1 1
 1 1 1 1   1 32 32 32 32 32 32  32 32 32 32 32 32 32  32 32 32 21 32 32 1   1 1 1 1
 1 1 1 1   1 32 32 32 32 32 32  32 32 32 32 32 32 32  32 32 32 21 32 32 1   1 1 1 1
 1 1 1 1   1 32 32 32 32 32 32  32 32 32 32 32 32 32  32 32 32 21 32 32 1   1 1 1 1

 1 1 1 1   1 1 1 1 1 1 1  1 1 1 1 1 1 1   1 1 1 1 1 1 1   1 1 1 1
 1 1 1 1   1 1 1 1 1 1 1  1 1 1 1 1 1 1   1 1 1 1 1 1 1   1 1 1 1
 1 1 1 1   1 1 1 1 1 1 1  1 1 1 1 1 1 1   1 1 1 1 1 1 1   1 1 1 1
 1 1 1 1   1 1 1 1 1 1 1  1 1 1 1 1 1 1   1 1 1 1 1 1 1   1 1 1 1
 1 1 1 1   1 1 1 1 1 1 1  1 1 1 1 1 1 1   1 1 1 1 1 1 1   1 1 1 1
 1 1 1 1   1 1 1 1 1 1 1  1 1 1 1 1 1 1   1 1 1 1 1 1 1   1 1 1 1
 1 1 1 1   1 1 1 1 1 1 1  1 1 1 1 1 1 1   1 1 1 1 1 1 1   1 1 1 1
 1 1 1 1   1 1 1 1 1 1 1  1 1 1 1 1 1 1   1 1 1 1 1 1 1   1 1 1 1