  11 11 11 11   11 11 11 11 11 11 11  11 11 11 11 11 11 11  11 11 11 11 11 11 11   11 11 11 11
  11 11 11 11   11 11 11 11 11 11 11  11 11 11 11 11 11 11  11 11 11 11 11 11 11   11 11 11 11
  11 11 11 11   11 11 11 11 11 11 11  11 11 11 11 11 11 11  11 11 11 11 11 11 11   11 11 11 11
  11 11 11 11   11 11 11 11 11 11 11  11 11 11 11 11 11 11  11 11 11 11 11 11 11   11 11 11 11
  11 11 11 11   11 11 11 11 11 11 11  11 11 11 11 11 11 11  11 11 11 11 11 11 11   11 11 11 11
  11 11 11 11   11 11 11 11 11 11 11  11 11 11 11 11 11 11  11 11 11 11 11 11 11   11 11 11 11
  11 11 11 11   11 11 11 11 11 11 11  11 11 11 11 11 11 11  11 11 11 11 11 11 11   11 11 11 11
  11 11 11 11   11 11 11 11 11 11 11  11 11 11 11 11 11 11  11 11 11 11 11 11 11   11 11 11 11

  11 11 11 11   11 32 32 32 32 32 32  32 30 30 32 32 32 32  32 32 32 32 32 32 11   11 11 11 11
  11 11 11 11   11 32 21 32 32 32 32  32 30 30 32 32 32 21  32 32 32 32 32 32 11   11 11 11 11
  11 11 11 11   11 32 34 34 34 32 32  32 32 30 30 32 32 32  32 32 32 32 32 11 11   11 11 11 11
  11 11 11 11   11 32 34 34 33 32 32  32 32 30 30 30 32 32  32 32 32 32 32 32 11   11 11 11 11
  11 11 11 11   11 32 34 32 32 32 32  32 30 30 30 32 32 32  32 32 32 32 32 11 11   11 11 11 11
  11 11 11 11   11 32 21 33 32 32 32  32 30 46 41 32 32 32  32 32 32 32 32 32 11   11 11 11 11
  11 11 11 11   11 32 33 32 32 32 32  32 30 32 30 32 32 51  50 52 32 32 32 32 11   11 11 11 11
  11 11 11 11   11 32 32 32 32 32 32  32 30 45 46 32 32 56  55 57 32 32 32 32 11   11 11 11 11
  11 11 11 11   11 32 32 33 32 32 32  32 32 30 30 41 32 54  53 58 32 32 32 32 11   11 11 11 11
  11 11 11 11   11 32 32 32 32 32 32  32 32 30  30 32 32  32 32 32 32 32 32 11   11 11 11 11
  11 11 11 11   11 32 32 32 32 32 32  32 32 32 30 30 45 30  32 32 32 21 32 32 11   11 11 11 11
  11 11 11 11   11 32 32 32 32 32 32  32 32 32 30 30 30 30  32 33 34 33 32 32 11   11 11 11 11
  11 11 11 11   11 32 32 32 32 32 32  32 32 32 32 30 30 30  30 32 34 34 32 32 11   11 11 11 11
  11 11 11 11   11 32 32 32 32 32 32  32 32 32 32 32 30 30  30 32 33 21 32 32 11   11 11 11 11

  11 11 11 11   11 32 32 32 32 32 32  32 32 32 32 30 30 30  30 32 33 34 21 32 11   11 11 11 11
  11 11 11 11   11 32 32 32 32 32 32  32 32 32 32 30 30 30  30 32 32 32 32 32 11   11 11 11 11
  11 11 11 11   11 32 32 51 50 52 32  32 32 32 32 30 30 32  30 32 32 32 32 32 11   11 11 11 11
  11 11 11 11   11 32 32 56 55 57 32  32 32 32 32 30 30 32  32 32 32 32 32 32 11   11 11 11 11
  11 11 11 11   11 32 32 54 53 58 32  32 32 32 32 30 30 32  32 32 32 32 32 32 11   11 11 11 11
  11 11 11 11   11 32 32 32 32 32 32  32 32 32 32 30 30 32  32 32 32 32 32 32 11   11 11 11 11
  11 11 11 11   11 32 32 32 32 32 32  32 32 32 32 30 30 32  32 32 32 32 32 34 11   11 11 11 11
  11 11 11 11   11 32 32 32 32 32 32  32 32 32 30 30 45 32  32 32 32 32 32 32 11   11 11 11 11
  11 11 11 11   11 32 32 32 32 32 32  32 32 30 30 30 32 32  32 32 34 33 32 32 11   11 11 11 11
  11 11 11 11   11 32 32 32 32 32 32  32 32 30 30 32 32 32  33 32 34 33 32 32 11   11 11 11 11
  11 11 11 11   11 32 32 32 32 32 32  32 32 30 30 32 32 32  32 33 33 34 32 32 11   11 11 11 11
  11 11 11 11   11 32 32 32 32 32 32  32 30 30 32 32 32 32  32 33 33 34 34 34 11   11 11 11 11
  11 11 11 11   11 32 32 32 32 32 32  30 30 32 32 32 32 32  32 33 34 33 34 34 11   11 11 11 11
  11 11 11 11   11 32 32 32 32 32 32  30 30 32 32 32 32 32  32 32 34 34 32 32 11   11 11 11 11

  11 11 11 11   11 11 11 11 11 11 11  11 11 11 11 11 11 11   11 11 11 11 11 11 11   11 11 11 11
  11 11 11 11   11 11 11 11 11 11 11  11 11 11 11 11 11 11   11 11 11 11 11 11 11   11 11 11 11
  11 11 11 11   11 11 11 11 11 11 11  11 11 11 11 11 11 11   11 11 11 11 11 11 11   11 11 11 11
  11 11 11 11   11 11 11 11 11 11 11  11 11 11 11 11 11 11   11 11 11 11 11 11 11   11 11 11 11
  11 11 11 11   11 11 11 11 11 11 11  11 11 11 11 11 11 11   11 11 11 11 11 11 11   11 11 11 11
  11 11 11 11   11 11 11 11 11 11 11  11 11 11 11 11 11 11   11 11 11 11 11 11 11   11 11 11 11
  11 11 11 11   11 11 11 11 11 11 11  11 11 11 11 11 11 11   11 11 11 11 11 11 11   11 11 11 11
  11 11 11 11   11 11 11 11 11 11 11  11 11 11 11 11 11 11   11 11 11 11 11 11 11   11 11 11 11