
  1 1 1 1   1 1 1 1 1 1 1  1 1 1 1 1 1 1  1 1 1 1 1 1 1   1 1 1 1
  1 1 1 1   1 1 1 1 1 1 1  1 1 1 1 1 1 1  1 1 1 1 1 1 1   1 1 1 1
  1 1 1 1   1 1 1 1 1 1 1  1 1 1 1 1 1 1  1 1 1 1 1 1 1   1 1 1 1
  1 1 1 1   1 1 1 1 1 1 1  1 1 1 1 1 1 1  1 1 1 1 1 1 1   1 1 1 1
  1 1 1 1   1 1 1 1 1 1 1  1 1 1 1 1 1 1  1 1 1 1 1 1 1   1 1 1 1
  1 1 1 1   1 1 1 1 1 1 1  1 1 1 1 1 1 1  1 1 1 1 1 1 1   1 1 1 1
  1 1 1 1   1 1 1 1 1 1 1  1 1 1 1 1 1 1  1 1 1 1 1 1 1   1 1 1 1
  1 1 1 1   23 23 23 23 23 23 23  23 23 23 23 23 23 23  23 23 23 23 23 23 23   1 1 1 1

  1 1 1 1   23 5 5 5 5 5 5  5 5 5 5 5 5 5  5 5 5 5 5 5 23   1 1 1 1
    1 1 1 1   23 5 2 5 5 5 5  5 5 5 5 5 5 21  5 5 5 5 5 5 23   1 1 1 1
    1 1 1 1   23 5 5 5 22 5 5  5 5 5 5 5 5 5  5 5 5 6 5 5 23   1 1 1 1
    1 1 1 1   23 5 5 6 5 5 5  5 5 5 5 5 5 5  5 5 5 5 5 5 23   1 1 1 1
    1 1 1 1   23 5 5 5 5 5 5  5 5 5 5 5 5 5  5 5 22 5 5 5 23   1 1 1 1
    1 1 1 1   23 5 2 5 5 5 5  5 6 5 5 5 5 5  5 5 5 5 5 5 23   1 1 1 1
    1 1 1 1   23 5 5 5 5 5 5  5 5 5 5 5 5 5  5 5 5 5 5 5 23   1 1 1 1
    1 1 1 1   23 5 5 5 5 5 5  5 5 5 22 5 5 5  5 5 5 5 5 5 23   1 1 1 1
    1 1 1 1   23 5 5 5 5 5 5  5 5 5 5 5 5 5  5 5 5 5 5 5 23   1 1 1 1
    1 1 1 1   23 5 5 6 5 5 5  5 5 5 5 5 5 5  5 5 5 5 5 5 23   1 1 1 1
    1 1 1 1   23 5 5 5 5 5 5  5 5 5 5 5 5 5  5 5 5 21 5 5 23   1 1 1 1
    1 1 1 1   23 5 5 5 5 5 5  5 5 5 5 5 5 5  5 5 5 5 5 5 23   1 1 1 1
    1 1 1 1   23 5 5 5 5 5 5  5 5 5 5 5 5 5  5 5 5 5 5 5 23   1 1 1 1
    1 1 1 1   23 5 5 5 5 5 5  22 5 5 5 5 6 5  5 5 5 5 5 5 23   1 1 1 1

     1 1 1 1   23 5 5 5 5 5 5  5 5 5 5 5 5 5  5 5 5 6 2 5 23   1 1 1 1
      1 1 1 1   23 5 5 5 5 5 5  5 5 5 5 5 5 5  5 22 5 5 5 5 23   1 1 1 1
      1 1 1 1   23 5 5 5 5 5 5  5 5 5 5 5 5 5  5 5 5 5 5 5 23   1 1 1 1
      1 1 1 1   23 5 5 5 5 5 5  5 5 5 5 5 5 5  5 5 5 5 5 5 23   1 1 1 1
      1 1 1 1   23 5 21 5 5 5 5  5 5 5 5 5 5 5  5 5 5 5 5 5 23   1 1 1 1
      1 1 1 1   23 5 5 5 5 5 5  5 5 5 5 5 5 5  5 5 5 5 5 5 23   1 1 1 1
      1 1 1 1   23 5 5 5 5 5 5  5 5 5 5 6 5 5  5 5 5 5 5 5 23   1 1 1 1
      1 1 1 1   23 5 5 5 6 5 5  5 5 5 6 5 5 5  5 5 2 5 6 5 23   1 1 1 1
      1 1 1 1   23 5 5 5 5 5 5  5 5 5 5 5 5 5  5 5 5 5 5 5 23   1 1 1 1
      1 1 1 1   23 5 5 22 5 5 5  5 5 5 5 5 5 5  5 6 5 5 5 5 23   1 1 1 1
      1 1 1 1   23 5 5 5 5 5 5  5 5 5 5 5 5 5  5 5 5 5 5 5 23   1 1 1 1
      1 1 1 1   23 5 5 5 5 5 5  5 21 5 5 5 5 5  5 5 5 5 5 5 23   1 1 1 1
      1 1 1 1   23 5 5 5 5 5 5  5 5 5 5 22 5 5  5 5 5 5 5 5 23   1 1 1 1
      1 1 1 1   23 5 5 5 5 5 5  5 5 5 5 5 5 5  5 5 5 5 5 5 23   1 1 1 1

      1 1 1 1   23 23 23 23 23 23 23  23 23 23 23 23 23 23   23 23 23 23 23 23 23   1 1 1 1
        1 1 1 1   1 1 1 1 1 1 1  1 1 1 1 1 1 1   1 1 1 1 1 1 1   1 1 1 1
        1 1 1 1   1 1 1 1 1 1 1  1 1 1 1 1 1 1   1 1 1 1 1 1 1   1 1 1 1
        1 1 1 1   1 1 1 1 1 1 1  1 1 1 1 1 1 1   1 1 1 1 1 1 1   1 1 1 1
        1 1 1 1   1 1 1 1 1 1 1  1 1 1 1 1 1 1   1 1 1 1 1 1 1   1 1 1 1
        1 1 1 1   1 1 1 1 1 1 1  1 1 1 1 1 1 1   1 1 1 1 1 1 1   1 1 1 1
        1 1 1 1   1 1 1 1 1 1 1  1 1 1 1 1 1 1   1 1 1 1 1 1 1   1 1 1 1
        1 1 1 1   1 1 1 1 1 1 1  1 1 1 1 1 1 1   1 1 1 1 1 1 1   1 1 1 1