  11 11 11 11   11 11 11 11 11 11 11  11 11 11 11 11 11 11  11 11 11 11 11 11 11   11 11 11 11
  11 11 11 11   11 11 11 11 11 11 11  11 11 11 11 11 11 11  11 11 11 11 11 11 11   11 11 11 11
  11 11 11 11   11 11 11 11 11 11 11  11 11 11 11 11 11 11  11 11 11 11 11 11 11   11 11 11 11
  11 11 11 11   11 11 11 11 11 11 11  11 11 11 11 11 11 11  11 11 11 11 11 11 11   11 11 11 11
  11 11 11 11   11 11 11 11 11 11 11  11 11 11 11 11 11 11  11 11 11 11 11 11 11   11 11 11 11
  11 11 11 11   11 11 11 11 11 11 11  11 11 11 11 11 11 11  11 11 11 11 11 11 11   11 11 11 11
  11 11 11 11   11 11 11 11 11 11 11  11 11 11 11 11 11 11  11 11 11 11 11 11 11   11 11 11 11
  11 11 11 11   11 11 11 11 11 11 11  11 11 11 11 11 11 11  11 11 11 11 11 11 11   11 11 11 11

  11 11 11 11   11 93 93 91 91 90 91  92 93 94 75 90 90 94  92 94 93 92 93 91 11   11 11 11 11
  11 11 11 11   11 93 94 94 93 90 90  91 91 61 94 92 91 91  91 91 90 93 78 90 11   11 11 11 11
  11 11 11 11   11 91 73 62 90 72 92  91 78 93 94 78 61 71  94 77 92 76 79 11 11   11 11 11 11
  11 11 11 11   11 94 93 63 62 93 93  90 79 74 61 79 91 90  93 72 91 94 62 74 11   11 11 11 11
  11 11 11 11   11 92 78 94 63 93 78  83 84 93 81 92 83 81  84 92 61 90 63 11 11   11 11 11 11
  11 11 11 11   11 93 79 91 71 82 79  81 84 77 80 71 82 83  80 82 93 71 94 93 11   11 11 11 11
  11 11 11 11   11 94 91 82 94 83 83  71 82 81 84 83 80 82  82 81 83 90 78 90 11   11 11 11 11
  11 11 11 11   11 90 74 90 83 82 81  84 83 72 81 80 11 84  84 92 94 75 79 90 11   11 11 11 11
  11 11 11 11   11 94 93 93 94 91 82  83 81 70 80 82 83 81  83 81 82 93 91 93 11   11 11 11 11
  11 11 11 11   11 91 93 74 94 83 84  80 83 82 81 84 80 71  83 91 83 90 93 91 11   11 11 11 11
  11 11 11 11   11 92 92 78 91 81 81  78 11 83 84 80 81 61  80 91 94 62 61 90 11   11 11 11 11
  11 11 11 11   11 91 93 79 93 92 83  79 82 81 71 83 84 82  81 82 83 74 71 94 11   11 11 11 11
  11 11 11 11   11 92 94 83 84 80 82  81 84 83 82 81 76 84  82 60 94 91 92 90 11   11 11 11 11
  11 11 11 11   11 93 94 75 82 71 83  74 82 81 84 83 80 82  83 94 91 93 94 90 11   11 11 11 11

  11 11 11 11   11 93 91 93 92 80 84  81 76 82 80 84 81 75  84 82 93 77 90 94 11   11 11 11 11
  11 11 11 11   11 94 73 62 83 80 82  83 81 84 80 71 83 81  82 81 82 93 74 93 11   11 11 11 11
  11 11 11 11   11 94 93 63 82 73 62  84 82 83 82 81 84 62  83 62 92 71 92 90 11   11 11 11 11
  11 11 11 11   11 90 75 90 73 81 63  80 72 82 84 83 70 63  81 63 82 94 92 91 11   11 11 11 11
  11 11 11 11   11 92 91 91 91 82 82  62 84 11 83 62 81 84  72 92 76 93 92 91 11   11 11 11 11
  11 11 11 11   11 94 92 81 82 80 83  63 82 81 75 63 84 78  83 92 91 90 91 90 11   11 11 11 11
  11 11 11 11   11 92 60 91 94 61 81  82 83 84 81 82 83 79  61 82 74 91 94 92 11   11 11 11 11
  11 11 11 11   11 90 91 93 91 84 84  83 82 76 84 83 82 81  84 74 90 93 78 94 11   11 11 11 11
  11 11 11 11   11 93 93 91 94 78 80  78 84 83 60 81 83 71  82 82 82 62 79 92 11   11 11 11 11
  11 11 11 11   11 91 93 71 90 79 83  79 84 71 91 83 82 84  70 83 92 63 93 92 11   11 11 11 11
  11 11 11 11   11 90 94 82 91 81 83  84 83 81 82 82 94 81  81 82 93 93 94 92 11   11 11 11 11
  11 11 11 11   11 93 93 90 61 90 74  92 93 62 71 75 91 91  62 84 72 91 93 91 11   11 11 11 11
  11 11 11 11   11 93 73 94 94 91 93  94 93 63 93 93 94 94  63 93 92 90 92 92 11   11 11 11 11
  11 11 11 11   11 91 94 91 92 93 94  93 90 90 94 91 93 92  90 93 92 94 93 94 11   11 11 11 11

  11 11 11 11   11 11 11 11 11 11 11  11 11 11 11 11 11 11   11 11 11 11 11 11 11   11 11 11 11
  11 11 11 11   11 11 11 11 11 11 11  11 11 11 11 11 11 11   11 11 11 11 11 11 11   11 11 11 11
  11 11 11 11   11 11 11 11 11 11 11  11 11 11 11 11 11 11   11 11 11 11 11 11 11   11 11 11 11
  11 11 11 11   11 11 11 11 11 11 11  11 11 11 11 11 11 11   11 11 11 11 11 11 11   11 11 11 11
  11 11 11 11   11 11 11 11 11 11 11  11 11 11 11 11 11 11   11 11 11 11 11 11 11   11 11 11 11
  11 11 11 11   11 11 11 11 11 11 11  11 11 11 11 11 11 11   11 11 11 11 11 11 11   11 11 11 11
  11 11 11 11   11 11 11 11 11 11 11  11 11 11 11 11 11 11   11 11 11 11 11 11 11   11 11 11 11
  11 11 11 11   11 11 11 11 11 11 11  11 11 11 11 11 11 11   11 11 11 11 11 11 11   11 11 11 11
