  11 11 11 11   11 11 11 11 11 11 11  11 11 11 11 11 11 11  11 11 11 11 11 11 11   11 11 11 11
    11 11 11 11   11 11 11 11 11 11 11  11 11 11 11 11 11 11  11 11 11 11 11 11 11   11 11 11 11
    11 11 11 11   11 11 11 11 11 11 11  11 11 11 11 11 11 11  11 11 11 11 11 11 11   11 11 11 11
    11 11 11 11   11 11 11 11 11 11 11  11 11 11 11 11 11 11  11 11 11 11 11 11 11   11 11 11 11
    11 11 11 11   11 11 11 11 11 11 11  11 11 11 11 11 11 11  11 11 11 11 11 11 11   11 11 11 11
    11 11 11 11   11 11 11 11 11 11 11  11 11 11 11 11 11 11  11 11 11 11 11 11 11   11 11 11 11
    11 11 11 11   11 11 11 11 11 11 11  11 11 11 11 11 11 11  11 11 11 11 11 11 11   11 11 11 11
    11 11 11 11   11 11 11 11 11 11 11  11 11 11 11 11 11 11  11 11 11 11 11 11 11   11 11 11 11

    11 11 11 11   11 81 81 81 81 81 81  81 81 81 81 81 81 81  81 81 81 81 81 81 11   11 11 11 11
    11 11 11 11   11 81 81 81 62 81 81  81 81 81 81 81 81 81  81 81 74 81 78 81 11   11 11 11 11
    11 11 11 11   11 81 81 81 63 81 81  81 81 75 81 81 81 71  81 81 81 81 79 81 11   11 11 11 11
    11 11 11 11   11 81 81 81 81 81 81  81 81 81 81 81 81 81  81 81 81 81 81 81 11   11 11 11 11
    11 11 11 11   11 81 78 81 81 81 62  83 84 81 81 81 83 81  81 81 61 81 81 81 11   11 11 11 11
    11 11 11 11   11 81 79 81 71 82 63  81 84 81 80 70 82 83  80 81 81 81 81 81 11   11 11 11 11
    11 11 11 11   11 81 81 81 81 83 83  81 82 81 84 83 80 82  82 81 81 81 78 81 11   11 11 11 11
    11 11 11 11   11 81 81 81 81 82 81  84 83 81 81 80 81 84  84 81 81 81 79 81 11   11 11 11 11
    11 11 11 11   11 81 81 81 81 81 82  83 81 81 80 82 83 81  83 81 81 81 81 81 11   11 11 11 11
    11 11 11 11   11 81 81 81 81 83 84  80 83 82 81 84 80 81  83 81 81 81 81 81 11   11 11 11 11
    11 11 11 11   11 81 81 78 81 81 81  81 81 70 84 80 81 62  80 81 81 75 81 81 11   11 11 11 11
    11 11 11 11   11 81 81 79 81 81 83  81 82 81 71 83 84 63  81 81 81 81 71 81 11   11 11 11 11
    11 11 11 11   11 81 81 83 81 80 82  81 84 83 82 81 81 84  82 81 81 81 81 81 11   11 11 11 11
    11 11 11 11   11 81 81 81 81 81 83  81 82 81 84 83 80 82  83 81 81 81 81 81 11   11 11 11 11

    11 11 11 11   11 81 81 81 81 80 84  81 81 82 80 84 81 81  84 81 81 81 81 81 11   11 11 11 11
    11 11 11 11   11 81 81 62 81 80 82  83 81 84 80 81 83 81  82 81 81 81 81 81 11   11 11 11 11
    11 11 11 11   11 81 81 63 81 81 62  84 82 83 82 81 84 62  83 81 81 81 81 81 11   11 11 11 11
    11 11 11 11   11 81 81 81 81 81 63  80 72 82 84 83 81 63  81 81 82 62 81 81 11   11 11 11 11
    11 11 11 11   11 81 81 81 81 82 82  81 84 81 83 81 70 84  81 81 81 63 81 81 11   11 11 11 11
    11 11 11 11   11 81 81 81 81 80 83  81 82 81 81 81 84 81  83 81 81 81 81 81 11   11 11 11 11
    11 11 11 11   11 81 81 61 81 81 81  82 83 84 81 82 83 81  81 81 81 81 81 81 11   11 11 11 11
    11 11 11 11   11 81 81 81 81 84 84  83 82 61 84 83 82 81  84 81 81 81 78 81 11   11 11 11 11
    11 11 11 11   11 81 81 81 81 81 80  81 84 83 81 81 83 71  82 81 82 81 79 81 11   11 11 11 11
    11 11 11 11   11 81 71 81 81 81 81  74 81 81 81 81 81 81  81 81 81 81 81 81 11   11 11 11 11
    11 11 11 11   11 81 81 81 81 81 81  81 81 81 81 81 81 81  81 81 70 81 81 81 11   11 11 11 11
    11 11 11 11   11 81 81 81 81 81 75  81 81 62 81 81 81 81  81 84 81 62 81 81 11   11 11 11 11
    11 11 11 11   11 81 81 81 70 81 81  81 81 63 81 81 81 81  81 81 81 63 81 81 11   11 11 11 11
    11 11 11 11   11 81 81 81 81 81 81  81 81 81 81 81 81 81  81 81 81 81 81 81 11   11 11 11 11

    11 11 11 11   11 11 11 11 11 11 11  11 11 11 11 11 11 11   11 11 11 11 11 11 11   11 11 11 11
    11 11 11 11   11 11 11 11 11 11 11  11 11 11 11 11 11 11   11 11 11 11 11 11 11   11 11 11 11
    11 11 11 11   11 11 11 11 11 11 11  11 11 11 11 11 11 11   11 11 11 11 11 11 11   11 11 11 11
    11 11 11 11   11 11 11 11 11 11 11  11 11 11 11 11 11 11   11 11 11 11 11 11 11   11 11 11 11
    11 11 11 11   11 11 11 11 11 11 11  11 11 11 11 11 11 11   11 11 11 11 11 11 11   11 11 11 11
    11 11 11 11   11 11 11 11 11 11 11  11 11 11 11 11 11 11   11 11 11 11 11 11 11   11 11 11 11
    11 11 11 11   11 11 11 11 11 11 11  11 11 11 11 11 11 11   11 11 11 11 11 11 11   11 11 11 11
    11 11 11 11   11 11 11 11 11 11 11  11 11 11 11 11 11 11   11 11 11 11 11 11 11   11 11 11 11